5,5
| 999_999 | 999_999 | 999_999 | 999_999 | 999_999 |
| 999_999 | 999X999 | 999_999 | 999X999 | 999_999 |
| 999_999 | 999X999 | 999X999 | 999X999 | 999_999 |
| 999_999 | 999_999 | 999X999 | 999X999 | 999_999 |
| 999_999 | 999_999 | 999_999 | 999X999 | 999_999 |
