5,5
| 0_999 | 0_999 | 0_999 | 0_999 | 0_999 |
| 0_999 | 0X999 | 0X999 | 0_999 | 0_999 |
| 0_999 | 0_999 | 0X999 | 0X999 | 0_999 |
| 0_999 | 0_999 | 0X999 | 0X999 | 0_999 |
| 0_999 | 0_999 | 0_999 | 0X999 | 0_999 |
